+-+-+-+-+-+-+-+-+-+-+-+-+-+-+-+-+-+-+-+-+-+-+-+-+-+-+-+-+-+-+-+-+-+-+-+-+-+-+-+-+-+-+-+-+-+-+-+-+-+-+-+-+-+-+-+-+-+-+-+-+
    |   | |     |   |   | |     |     |     |       |         |   |   |   |   |   |   |           |   |   | |           |
+-+ + + + + +-+ + + + + + + +-+ + +-+ + +-+ + + +-+ + +-+-+-+ + + + + + + + + +-+ + + +-+-+-+ +-+ +-+ + + + + +-+-+-+-+ +
|   | | |   |   | |   | |     | | |   |   | | | |   |     |   | | | |   |   | |   | |     |   |     | | |     |     |   |
+ +-+ + +-+ + +-+ + +-+ +-+-+ + + + +-+-+ + + +-+ +-+-+-+ + +-+-+ + +-+-+-+-+ + +-+-+-+-+ + +-+-+ + + + + +-+-+ +-+ + +-+
|     | |   | |   | | |   | | |   |     | |   |   |     | | |   | |   |       | |     |   |     | | | | | |     |   |   |
+-+-+-+ + +-+ + +-+ + + + + + +-+-+-+-+ + +-+ + +-+ +-+ + + +-+ + +-+ + +-+-+ + + +-+ + +-+-+-+ +-+ + +-+ +-+-+ + +-+-+ +
|       | | |   | |   | |     |   |   |   |   | |   |   | |   |     | |     | | | | |       |   |   |   |   |   |     | |
+ +-+-+ + + + +-+ + +-+-+-+ +-+-+ + + +-+-+-+-+ + +-+ +-+ +-+ +-+ +-+ +-+-+ +-+ + + +-+-+-+ +-+-+ +-+-+ +-+ + +-+-+-+ + +
|   |   | |   |   |   |   |       | |   | |   |   | | | | |     | |   |   |     |   |     | |   | |     | | |   |   |   |
+ + + +-+ +-+-+ +-+ +-+ + +-+-+-+-+ +-+ + + + + +-+ + + + + +-+-+ + +-+ + +-+-+ +-+-+ +-+-+ + + + + +-+-+ + +-+ +-+ +-+-+
| | |     |   | |   |   |     |   |   | |   | |     | |   | |     | |   |       |     |     | |   | |     |   |   | |   |
+ + +-+-+-+-+ + + +-+ +-+-+-+ + +-+-+ + +-+-+ +-+ +-+ + + + + +-+-+ +-+-+-+ + +-+ +-+-+ +-+-+ +-+-+ +-+-+ +-+ +-+ + + + +
| | |   |     |   |   |     | |   | | | | |   |   | |   | | | |   |   |   | |   | |   | |     |     |       |   |   | | |
+ + + + + +-+-+-+-+ +-+ +-+-+ +-+ + + + + + +-+ +-+ +-+-+ + + + +-+-+ + +-+ +-+ + + + + + +-+-+ +-+-+ +-+-+ +-+ +-+-+-+ +
| |   | | | |     |   |       | |     | | |   |   |       | |       | |     | |     |   |       |   | |   | |         | |
+ +-+-+ + + + +-+ +-+ + +-+-+-+ +-+ +-+ + +-+ +-+-+ +-+-+-+ +-+-+-+ + +-+-+-+ +-+-+-+-+-+-+ +-+-+ + + + +-+ +-+-+ +-+ + +
|     | |   | |       |       |     | | |     |     |       |     |     |     |       |   |   |   | | |     |   | |   | |
+-+ + + + +-+ +-+ +-+-+-+-+-+ +-+-+ + + +-+-+ + +-+-+ +-+-+-+ +-+ +-+-+ + +-+ + +-+-+ + + + + + +-+ + +-+-+-+ + + + +-+ +
|   | |   |     |   |         |       |   |   |     | | |   |   |   |       | |   |     | | |   |   | |     | |   |     |
+-+-+ +-+-+ +-+ +-+ + +-+-+-+-+-+ +-+-+-+ + +-+ +-+ + + + + +-+-+-+ + +-+-+ +-+-+ + + +-+ + +-+-+ +-+ + +-+ + +-+-+-+-+-+
|     |   |   | |   | |     |     |         | | | | |   | |           |     |     | | | | | |     |   |   |   |         |
+ +-+-+ +-+-+ + +-+-+-+ +-+ + +-+ + +-+-+-+-+ + + + +-+-+ +-+ +-+-+ +-+ +-+-+ +-+-+ + + + + + +-+-+ +-+-+ +-+-+ +-+-+-+ +
| |   |       |         |   | | | |     |   |   | | |       |   |   |   |   | |   | | | |   | |         |     |   |   | |
+ + + +-+-+-+-+-+ +-+-+-+ +-+ + + +-+-+-+ + +-+-+ + + +-+ +-+-+ +-+-+-+-+ + + +-+ + + + +-+-+ + +-+-+ + +-+ + +-+ + + + +
|   |     |     |       |   | | |       | |         | |       |         | |   |   | | | |   | | |     |   | | |   | | | |
+ +-+-+-+ + +-+ +-+-+ +-+-+ + + +-+-+-+ + +-+-+-+-+-+-+ + +-+ +-+-+-+-+ + +-+-+ +-+ + + + + + + + +-+-+-+ + + + +-+ + + +
| |     | |   |       |     |   |               |       | |   |   | |   | |   | |   | | | | |   |       |   | |   | |   |
+ + +-+ +-+-+ +-+-+-+-+ +-+-+-+ + +-+-+-+-+-+-+ + +-+-+-+-+ + + + + + +-+ + + + + +-+ + + + +-+-+-+-+ + +-+-+-+-+ + +-+-+
| | |   |     |   |     |   |   |   |       |   |     |   | | | |   | |   | | |   | |   | | |   |     |   |       |     |
+-+ + +-+ +-+-+ + +-+-+ +-+ + +-+-+ + +-+-+ + +-+-+-+ + + + + + +-+-+ + +-+ + +-+-+ +-+-+-+ + +-+ +-+-+-+ +-+-+-+-+-+-+ +
|   | | |     | |         | | |     | |     |       |   | | | |       |   | |     | |       |     |   |     |   |       |
+ +-+ + + +-+ + +-+-+-+-+ + +-+ +-+-+ + +-+-+-+ +-+-+-+-+ + +-+-+-+-+-+-+ + + +-+ + + +-+-+-+-+ +-+ + +-+-+ + + +-+-+ +-+
| |   | | | | | |       | | |   | |   | |   |   |       | |   |   |   |   | |   |   |     |   | |   |     |   |   | |   |
+ +-+-+ + + + + + +-+-+ + + + +-+ + +-+ +-+ +-+-+ + +-+ + +-+ + + + + + +-+ + + +-+-+-+-+ +-+ + + +-+-+-+ +-+-+-+ + +-+ +
| |   |   |   | | |   | |   | |     |     |   |   |   |   |   | |   |   |   | | |   |   |   |     |       |       |     |
+ + + +-+-+-+ + + + + + +-+-+ + +-+-+ +-+ +-+ + +-+-+-+-+-+ +-+ +-+-+-+-+ +-+-+ + + +-+ +-+ +-+ +-+ +-+-+-+ +-+-+-+ +-+-+
| | |   |   | | | | |   |     |     |   |     | | |     |     |     |   | |     | |   |   | |   |   |     | |   |       |
+ + +-+ + + + + + + +-+-+ +-+-+-+ + +-+ +-+-+-+ + + +-+ +-+ + +-+ +-+ + + + +-+-+ +-+ +-+ + + +-+-+-+-+-+ + + + + +-+-+ +
|   | |   | | |   | |   |   |   | |   |   |   | |   |   |   |       | |   | |     | | |   | |   |       | |   | |   |   |
+-+-+ +-+ + + +-+-+ +-+ +-+ + + +-+-+ +-+ + +-+ +-+-+-+ + +-+-+-+-+ +-+ +-+ + +-+-+ + + +-+ +-+-+ +-+-+ + +-+-+ +-+ + +-+
| |   |   | |   | | |   | |   |     | | | |           | |     |     |   |   | |     |   |   |   |     |           | | | |
+ + +-+ + + +-+ + + + +-+ + +-+-+-+ + + + + +-+-+-+-+ + + +-+ + +-+-+ + + +-+ + +-+-+-+-+ +-+ + +-+-+ +-+-+-+-+-+-+ + + +
| | |   | |   |   |   | | |   |     | | |     |     | | | |   |       | |   | | | |   | |   | |     |         |   | |   |
+ + +-+-+-+-+ + + +-+-+ + +-+ +-+-+-+ + +-+ + +-+-+ + + +-+ +-+-+-+-+-+-+ + + + + + + + +-+ + +-+-+ +-+-+-+-+ + + + +-+-+
|               | |   |     | |   |   |     |   |   | |     |   |         |     |   | | |     |   |       | |   |     | |
+-+ +-+-+-+-+ +-+ + +-+-+ +-+ + + + +-+-+-+-+-+ +-+ + +-+-+-+ +-+ +-+-+-+-+-+-+-+ +-+ + +-+-+ + + +-+-+ + + +-+-+-+ + + +
| |     |     |   |       |   | | | |   |     |     |     |   |   | |           | |   |   |   | | |     |           | | |
+ +-+-+-+ +-+-+ +-+-+-+ + + + + + + + + + +-+ +-+-+-+-+-+ + +-+ +-+ + +-+-+-+-+ +-+ +-+ + + +-+ +-+ +-+-+-+-+-+-+-+-+ + +
| |       |   | |       |   |   |   | | |   | |       |   |   |     | |       |   | |   | | | |     |     |     |   |   |
+ + +-+-+-+-+ + + +-+-+-+-+-+-+-+-+ + + +-+ + + + +-+ + + + + + +-+-+ + + +-+-+-+ + + +-+ + + + +-+-+ +-+ + +-+ + + +-+ +
|       |   |   | |   |     |       | |   | |   | |   | | | | | | |   | | |       |   | | |   |     | |   |   |   |   | |
+ + +-+-+ + +-+-+ + + + +-+-+ +-+-+-+ +-+ + +-+-+ + +-+ + + +-+ + + +-+ + + +-+-+-+-+-+ + +-+ +-+-+-+ + +-+-+ +-+-+-+ + +
| |       |       | |         |   |   | | |     | | |   | |     |   |   | |     |     | |     | |   | |   |   |   |   | |
+-+-+-+-+-+-+-+-+-+ +-+-+-+-+ + + + + + + +-+ + + + +-+-+ +-+ +-+ +-+ +-+ +-+ + +-+-+ + +-+-+-+ + + + +-+ + + + + + +-+ +
|   |             |     |   |   |   | |   |   | | |         |   |   | | |     | |   |       | | | | |   | | | | |   |   |
+ + + +-+-+-+-+ +-+-+-+-+ + +-+-+-+-+ +-+-+-+-+ +-+-+-+-+-+-+ + +-+ + + +-+ +-+ + + +-+-+-+ + + + + +-+ + +-+ + +-+ + +-+
| | |     |   | |         |     |   | |   |   |   |   |     | |     |   |     |   | |   |   |     |     |     | |   |   |
+ +-+-+-+ + +-+ + +-+-+-+ +-+-+ + + + + + + + +-+ + + +-+-+ + +-+-+-+-+-+-+-+ +-+-+ + + + +-+ +-+-+-+-+-+-+-+-+ +-+-+-+ +
|         |   |   | |     | |   | | |   | | |     | | |     |       |     |   |     | | | |       |     |       |     | |
+-+-+-+-+ +-+ +-+-+ + +-+ + + +-+-+ +-+-+-+ +-+ +-+ + + +-+-+-+-+-+-+ +-+ + +-+-+ + + + + + +-+-+ +-+ + +-+ +-+-+ +-+ + +
|       | | | |   |   |   |                 |       |   |   |         | |   |   | | | | | |     |   | |     |       | | |
+ +-+-+ + + + +-+ +-+-+-+-+-+-+-+-+ +-+ +-+-+ +-+-+-+-+-+ + + +-+-+-+-+ +-+-+ + + +-+ + + + +-+ +-+ +-+-+-+-+ +-+-+-+ + +
| |     |   | |     |     |         |   |   | |       |   |   |   |     |   | | |     |   |   | | |   | |     |       | |
+ + +-+-+-+-+ + + + + +-+ + +-+-+-+-+-+-+ +-+ +-+ +-+-+ +-+-+-+ +-+ +-+-+ + + + +-+-+-+-+-+-+ + + +-+ + + +-+-+ +-+-+-+ +
| | |     |     | | | | | | |     |     |   |   | |     |     |   | |   | |   |       |       |   |     | |   |         |
+ + + +-+ + + +-+ +-+ + + + + + + + +-+ + + +-+ + + +-+-+ + +-+-+ + + + + +-+-+-+-+-+ + +-+-+-+-+-+ + +-+ + + +-+-+-+-+-+
| |   |   | |   |     | |     | |   | | | |     | |     | |   |   | | |   |   |   | | |     |       |     | |       |   |
+ +-+-+-+-+ + +-+-+-+-+ +-+ +-+ +-+-+ + +-+-+-+-+ +-+ + +-+-+ + + + + +-+-+ + +-+ + + +-+ + +-+-+-+-+-+-+-+ +-+-+ + + + +
|           |         |       |       |           |   |         |   |       |     |       |                 |     |   |  
+-+-+-+-+-+-+-+-+-+-+-+-+-+-+-+-+-+-+-+-+-+-+-+-+-+-+-+-+-+-+-+-+-+-+-+-+-+-+-+-+-+-+-+-+-+-+-+-+-+-+-+-+-+-+-+-+-+-+-+-+