+-+-+-+-+-+-+-+-+-+-+
      |     |   |   |
+-+-+ + + +-+ + +-+ +
|     | |     |   | |
+ +-+ + + +-+-+-+ + +
| |   | | |     |   |
+ +-+-+ + + +-+ +-+-+
|   |   |   |   |   |
+-+ + +-+-+-+ +-+ + +
|   | |     |     | |
+ +-+ + +-+ +-+-+-+ +
| |   |   | |       |
+ + +-+-+-+ + +-+-+-+
|           |   |   |
+-+ + +-+-+-+-+ + + +
|   | |   |   | | | |
+ +-+-+ + +-+ + + + +
|       |   | |   | |
+-+-+-+-+-+ + +-+-+ +
|             |      
+-+-+-+-+-+-+-+-+-+-+