+-+-+-+-+-+-+-+-+-+-+-+-+-+-+-+-+-+-+-+-+-+-+-+-+-+-+-+-+-+-+-+-+-+-+-+-+-+-+-+-+
        |   |             |   |   |       |   |   | |   |             |     |   |
+ +-+-+ + + +-+ + +-+-+ +-+ + +-+ + +-+-+ + +-+ + + + + +-+-+-+-+-+-+ +-+-+ + + +
|   | |   |   | | |   |     |     | | |   |     | | | |       |   |   |       | |
+-+ + +-+-+-+ + + +-+ +-+-+-+-+-+-+ + + + +-+-+-+ + + +-+-+-+ + + + +-+ +-+ +-+ +
|   |       |   |   |   |   |   |   |   | |     | |     |     | | |   |   | |   |
+ +-+-+-+-+ +-+-+-+ +-+ + + + + + +-+-+-+ +-+ + + + +-+-+ +-+-+ + +-+ +-+ + + +-+
|     |   |   |       |   | | | |       |   | |   | |   |       | |   |   | | | |
+-+-+ + + +-+ +-+-+-+ + +-+-+ + +-+-+-+ +-+ + +-+-+-+ + +-+ +-+-+ + +-+-+-+ + + +
|     | |   |         | |     | |   |   |   | |     | | |   |     | |   |   |   |
+ + +-+-+-+ +-+-+-+-+-+ + +-+-+ +-+ + +-+ +-+ + +-+ + + + +-+-+-+-+ + + + +-+-+-+
| |       | |     |   | | |     |   |   |     | |   | | |   |       | |         |
+ +-+-+-+ + + +-+ + +-+ + + +-+-+ + + + +-+-+-+ + +-+ + +-+ + +-+-+-+ + + +-+-+ +
|       |   | |   |   | | | |   | |   | |       | |   |   | | |       | | |   | |
+ +-+-+ +-+-+ + +-+ + + + + + + + +-+-+ + + +-+-+ + +-+-+ + + +-+-+-+-+ + + + + +
| |     |     | |   | | | | | |   |     | | |     |   |   | | |   |     | | |   |
+ +-+-+-+ +-+-+ +-+-+ + + + + +-+-+ + +-+ + + +-+-+-+ + +-+ + + + +-+-+-+ +-+-+ +
|     | |   |           | |   |     | |   | |   |     | |   |   |     |   |     |
+-+-+ + +-+ + +-+-+-+ +-+ +-+-+-+-+-+-+ +-+ +-+ + + +-+ + +-+ +-+-+-+ + +-+ +-+-+
|       |   |   | |       |   |   |   |   |   | | |   |   |   |       |   | |   |
+ +-+-+-+ +-+-+ + + + +-+-+ + + + + + + +-+-+ + + +-+ +-+-+ +-+ +-+-+-+-+ + + + +
|   |   | |   | |   | |     |   |   | |     | | |   | |   | |   |       | | | | |
+-+ + + + + +-+ + +-+-+ +-+-+-+ +-+-+ +-+-+ + + +-+ + + + + + +-+ +-+-+ + + + + +
|   | | | |     |     |       | |     |     | |     |   |   | |   |   |   |   | |
+ +-+-+ + +-+-+-+-+-+ + +-+-+ + + +-+-+ +-+-+ +-+ +-+-+-+-+-+ + +-+ +-+-+-+-+-+ +
| |   |         | |   | |     | | |     |   | |   |     |     |   |     |     | |
+ +-+ +-+ +-+-+ + + +-+ +-+ +-+-+ + +-+-+ + + + +-+ +-+ + +-+-+-+ + +-+ + +-+ + +
| |     |   | |   | |   |   |     |   |   |   |   | |   |   |   | |   | | |   | |
+ + +-+ +-+ + +-+-+ +-+-+ + + +-+ +-+-+ +-+-+-+-+ + +-+-+-+ + + +-+-+ + + + +-+ +
|   |   |   |   | |       | |   |           | |   |   |   |   |     | |   |   | |
+-+ + +-+ +-+-+ + +-+-+-+-+-+-+ +-+-+-+-+-+ + + +-+-+ + + +-+ +-+-+ + +-+-+-+ + +
|   | |   |   | |   |   |       |           |     | |   |   |     |   |   |   | |
+ +-+ + +-+ + + + +-+ + + + + +-+-+ +-+-+-+-+-+ + + +-+-+-+ +-+-+ +-+-+-+ + +-+ +
| |     | | |   |     | | | | |   |     |     | |   |   |   |     |     | |     |
+ +-+-+-+ + +-+-+-+-+-+ +-+ + +-+ +-+ +-+ +-+ + +-+ + + + +-+ +-+-+-+-+ + +-+-+-+
|     |   |       | |       |     |   |   | |   | | | |   |   |     | | |       |
+-+-+ + +-+-+-+-+ + + + +-+-+-+-+-+-+-+ +-+ +-+-+ + + +-+-+ +-+ +-+ + + + +-+-+-+
| |   |         | |   | |       |       |   |   |   |     |   |   |     |       |
+ + +-+-+-+-+-+ + + +-+ +-+-+-+ + +-+-+-+ + + + +-+-+-+ +-+-+ +-+ +-+ +-+-+-+-+ +
|   |     |   | |   |   |   |   |       | |   | |     | |   | |   | |     |     |
+-+-+ +-+ + +-+ + +-+ +-+ + + +-+-+-+ +-+ +-+-+ + +-+ + + + + + +-+ +-+-+ + +-+-+
|   |   | | |   |   | |   | | | |   |     |   |   |     | |   | |     | | |     |
+ +-+-+-+ + + +-+-+ + + + + + + + + +-+-+-+ + +-+-+-+-+-+ +-+-+ + +-+ + + + +-+-+
|     |   |       | |   | |   |   | |   |   |   |   |     |   | |   |   | |     |
+-+ + + + +-+ + + +-+-+-+-+ +-+-+-+ + + + + +-+ + + + + +-+-+ + +-+ +-+ + +-+-+ +
|   | | | |   | |           |       | | | | | |   |   | |   | |   |   | |   |   |
+ +-+ + +-+ +-+-+-+-+-+-+-+-+-+ +-+-+ + +-+ + +-+-+-+-+ +-+ + +-+ +-+ + +-+ + +-+
|   | |     |     |       |   | |     |     | |       |     |       | |     |   |
+-+-+ +-+-+-+ +-+ + +-+-+ +-+ + + + +-+-+-+-+ +-+-+-+ +-+-+-+-+ +-+ + +-+ +-+ +-+
|   | |     |   | | |   |     |   | |   |     |       |     |   |   | | |   |   |
+ + + +-+-+ +-+ + + + + +-+-+-+-+-+ + + + +-+-+ +-+-+ + + +-+ +-+ +-+ + +-+ + + +
| | | |         | | | |     |       | |   |     |   |   | |   | | |   | | |   | |
+ + + + +-+-+-+-+ + + +-+-+ + +-+-+-+ +-+-+ + +-+ + +-+-+ + +-+ + + +-+ + +-+-+ +
| |   |     |     | |     |         |       |   | |       |   |   | |   |     | |
+ +-+-+-+-+ +-+-+-+ +-+ +-+-+-+-+-+ +-+-+-+-+-+ + +-+-+-+-+-+ +-+ + + +-+ +-+-+ +
|         |       |   | |   |     |   |     |   |     |     | |   |   |         |
+-+-+ +-+ +-+-+-+ +-+ +-+ + + +-+ + + + +-+ + +-+-+ + + +-+ + + +-+-+-+-+-+-+-+-+
|   |   |   |   |         | |   |   |   |   |   |   |   |   | | |       |       |
+ + +-+ +-+-+ + +-+-+ +-+ + +-+ +-+-+-+-+ +-+-+ +-+-+-+-+-+-+ +-+ +-+ + + + +-+-+
| |   |       |   |   |   |       |       |   |   |             | |   | | |     |
+ +-+ +-+-+-+-+ +-+ +-+-+-+-+ +-+-+ +-+-+-+ + +-+ +-+-+-+ +-+-+ + + +-+ + +-+-+ +
|   |       |     | |         | |   |   |   |   |       | |   | | | | | | |   | |
+-+ +-+-+-+ +-+-+ + +-+ +-+ +-+ + +-+ + + + +-+ +-+ +-+-+ +-+ + + + + + + + +-+ +
| |   |   |     | | |     | |   | |   | | |   | |   |   | |   |   | |   | | |   |
+ +-+ + + +-+-+ + + + +-+ +-+ +-+ + +-+ + +-+ + + +-+ + + + +-+-+-+ +-+-+ + + +-+
|   |   |     | |   |   |     |     |   | |   | | |   |   |     | | |     |   | |
+ + +-+-+-+-+ + +-+-+-+ +-+-+-+ +-+-+ +-+ +-+ + + + +-+-+-+-+-+ + + + + +-+ +-+ +
| | |         |         |       |     |   |   |   | |   |   |   |     | |   |   |
+ + + +-+-+-+-+-+-+-+-+-+ +-+-+-+ +-+-+ + + +-+-+-+ + + + + + +-+ +-+-+ + +-+ +-+
  |   |                   |             | |           |   |   |   |     |       |
+-+-+-+-+-+-+-+-+-+-+-+-+-+-+-+-+-+-+-+-+-+-+-+-+-+-+-+-+-+-+-+-+-+-+-+-+-+-+-+-+